αι,110001
ει,100101
οι,010101
ου,101001
υι,110111
αυ,100001
ευ,100011
ηυ,110011
