.,010011
",",010000
',001000
;,010001
:,011000
-,001001
(,011011
),011011
«,011001
»,001011
 ,000000
́,000010
