α,100000
ε,100010
η,001110
ι,010100
ο,101010
υ,101111
ω,010110
